// Level 1
111111118 111111111
100020000 010000001
111001110 010111101
101000000 000100101
101011111 111001101

101010000 000000001
100011110 110111101
101010000 100020001
101000100 100000001
191111111 111111111

