// Level 5
111111118 111111111
100000000 000000001
100001100 011000001
100001000 000000101
101001000 011111001

100101100 010001101
101000000 000000101
100001105 000010001
100000000 000000001
111111119 111111111
